久泻久痢	二便
便干结如羊粪	二便
便溏	二便
便溏不爽	二便
便秘	二便
便秘尿黄	二便
呕恶便溏	二便
夜尿频多	二便
大便夹浓血	二便
大便干结	二便
大便清稀或完谷不化	二便
大便秘结	二便
大便色黄而臭	二便
小便短少	二便
尿少	二便
尿少便干	二便
尿道灼痛	二便
尿频尿急,尿道灼痛	二便
尿频而清	二便
尿黄便秘	二便
尿黄赤浑浊	二便
或尿血,或尿有砂石	二便
泻下物臭秽如败卵	二便
泻下青黑粪水	二便
里急后重	二便
下午3点到5点潮热汗出	全身
两手两足心发热	全身
体胖痰多	全身
倦怠乏力	全身
健忘	全身
内脏下垂	全身
冷汗淋漓	全身
出血	全身
发热,烦渴	全身
口淡不渴	全身
口渴	全身
呼吸微弱	全身
善太息	全身
声低息微,肢体欠温	全身
声低懒言	全身
声低懒言,自汗乏力	全身
多梦	全身
失眠	全身
失眠健忘	全身
失眠多梦	全身
头身疼痛	全身
头重身困	全身
小儿发育迟缓	全身
少气懒言	全身
形体消瘦	全身
形寒肢冷	全身
得温痛减	全身
微恶风寒	全身
恶寒发热	全身
恶心欲吐	全身
惊悸失眠	全身
或面青肢冷,或咽干颧红	全身
时常叹气	全身
气短,劳后加重	全身
水肿下肢为甚	全身
浮肿	全身
潮热盗汗	全身
烦躁不安	全身
爱叹气,急躁易怒	全身
猝然昏倒	全身
畏冷肢凉	全身
皮肤巩膜黏膜发黄	全身
皮肤薄而亮	全身
盗汗	全身
神疲乏力	全身
肌肉掣动	全身
肢体浮肿	全身
肢体酸痛,疲劳困倦	全身
肢体麻木	全身
自汗	全身
自汗,身疲	全身
表情淡漠	全身
角弓反张	全身
身体困重	全身
身热不扬	全身
身热气粗	全身
面浮肢肿	全身
面白发亮无血色	全身
面白无光泽	全身
面色发黄,色晦暗不泽	全身
面色晦暗或s白	全身
面色淡白	全身
面色萎黄或淡白无光泽	全身
面赤气粗	全身
面黄肌瘦	全身
颧红盗汗	全身
颧红盗汗,骨蒸潮热	全身
食欲下降	全身
高声狂躁	全身
高热神昏	全身
口燥咽干	咽喉
喉中痰鸣	咽喉
声音嘶哑	咽喉
四肢不温	四肢
四肢抽搐	四肢
手足抽搐缓慢无力	四肢
手足震颤	四肢
爪甲干枯脆薄	四肢
畏寒肢冷	四肢
肢体不温	四肢
肢冷	四肢
肢麻关节屈伸困难	四肢
两眼干涩,视物模糊	头面
口眼歪斜	头面
口臭	头面
口舌生疮	头面
口苦	头面
口鼻干燥	头面
头刺痛	头面
头摇而痛	头面
头晕目眩	头面
头晕胀痛	头面
头痛咽喉痛	头面
头目胀痛	头面
头重脚轻	头面
头顶冷痛	头面
牙关紧闭	头面
牙龈肿痛	头面
眩晕	头面
眩晕欲仆倒	头面
眩晕耳鸣	头面
眼及面部浮肿	头面
面唇淡白无华	头面
面白	头面
面白亮	头面
面白亮或晦暗	头面
面红目赤	头面
面色无华	头面
面色晦暗	头面
面色晦滞	头面
面色萎黄	头面
面色萎黄或淡白	头面
面苍白	头面
面赤口渴	头面
面部烘热	头面
颧红	头面
鼻塞流清涕	头面
鼻,胸闷胸痛	头面
妇女月经失调	妇科
女子月经淋漓不尽,胎动易滑	生殖
生殖能力下降	生殖
男子不育,女子不孕	生殖
男子滑精早泄	生殖
遗精,月经不调	生殖
急躁易怒	精神
情志抑郁	精神
吐痰色黄	肺
厌食嗜食	胃脘
呃逆	胃脘
呕吐清稀口水	胃脘
嗳气	胃脘
嗳腐吞酸	胃脘
恶心呕吐	胃脘
打嗝吞酸	胃脘
泛吐清水	胃脘
畏食生冷	胃脘
胃中空虚	胃脘
胃脘,胁肋胀痛或窜痛	胃脘
食少	胃脘
食少便溏	胃脘
食少腹胀便溏	胃脘
食欲亢剩	胃脘
饥不欲食	胃脘
饮食减少	胃脘
久病咳喘无力	胸
五心烦热	胸
发热,咳喘	胸
咯痰量多清稀	胸
咯腥臭脓痰	胸
咳喘哮鸣	胸
咳喘无力	胸
咳喘气急	胸
咳喘气短	胸
咳嗽	胸
咳嗽或咳血	胸
咳痰清稀	胸
咳痰黄稠	胸
干咳少痰	胸
干咳无痰	胸
干咳痰少而黏	胸
心悸	胸
心悸健忘	胸
心悸咳喘	胸
心悸失眠	胸
心悸怔忡	胸
心烦	胸
心烦心悸	胸
心胸憋痛	胸
心胸突然剧痛	胸
痛如针刺	胸
痰少而黏	胸
痰白清稀量多	胸
胀痛	胸
胸胁灼痛	胸
胸胁胀满窜痛	胸
胸闷气短	胸
少腹冷痛	胸腹
纳呆呕恶	胸腹
胁肋气胀痛	胸腹
胁肋灼痛	胸腹
胁肋胀痛	胸腹
胁肋隐痛	胸腹
胸闷	胸腹
发热腰痛	腰
腰腹冷痛	腰
腰膝酸软	腰
腰膝酸软冷痛	腰
腰膝酸软而痛	腰
纳呆腹胀便溏	腹
胃脘冷痛	腹
胃脘冷痛拒按	腹
胃脘灼痛拒按	腹
胃脘灼痛隐隐	腹
胃脘胀痛	腹
胃脘隐痛	腹
脐腹部疼痛	腹
脘腹坠胀	腹
脘腹满闷不舒	腹
脘腹胀满	腹
脘腹胀满不舒	腹
腹痛	腹
腹胀	腹
腹胀作痛	腹
腹胀痛拒按	腹
腹部隐痛	腹
神志异常	阳
意识模糊	阴
阴部冷痛	阴部